80*63
                                                                                
 FFFFFFFFFFFFFFFFFFFFFFFFFFFFFFFFFF      FFFFFFFFFFFFFFFFFFFFFFFFFFFFFFFFFFFFFF 
 FFFFFFFFFFFFFFFFFFFFFFFFFFFFFFFFFF      FFFFFFFFFFFFFFFFFFFFFFFFFFFFFFFFFFFFFF 
 FFFFFFFFFFFFFFFFFFFFFFFFFFFFFFFFFF      F3FFFFFFFFFFFFFFFFFFFFFFFFFFFFFFFFFFFF 
 FFFFFFFFFFFFFFFFFFFFFFFFFFFFFFFFFF      FFFFFFFFFFFFFFFFFFFFFFFFFFFFFFFFFFFFFF 
 FFFFFFFFFFFFFFFFFFFFFFFFFFFFFFFFFF      FFFFFFFFFFFFFFFFFFFFFFFFFFFFFFFFFFFFFF 
 FFFFFFF                  FFFFFFFFF                                  FFFFFFFFFF 
 FFFFFFF                  FFFFFFFFF                                  FFFFFFFFFF 
 FFFFFFF                  FFFFFFFFF                                  FFFFFFFFFF 
 FFFFFFF                  FFFFFFFFFFFFFFFFFFFFFFFFFFFFFFFFFFFFFFFFFFFFFFFFFFFFF 
 FFFFFFF                  FFFFFFFFFFFFFFFFFFFFFFFFFFFFFFFFFFFFFFFFFFFFFFFFFFFFF 
 FFFFFFF                  FFFFFFFFFFFFFFFFFFFFFFFFFFFFFFFFFFFFFFFFFFFFFFFFFFFFF 
 FFFFFFF                  FFFFFFFFFFFFFFFFFFFFFFFFFFFFFFFFFFFFFFFFFFFFFFFFFFFFF 
 FFFFFFF                                                      FFFFFFFFFFFFFFFFF 
 FFFFFFF                  FFFFFFFFFFFFFFFFFFFFFFFFFFFFFFFFFFF FFFFFFFFFFFFFFFFF 
 FFFFFFF                  FFFFFFFFFFFFFFFFFFFFFFFFFFFFFFFFFFF FFFFFFFFFFFFFFFFF 
 FFFFFFF                  FFFFFFFFFFFFFFFFFFFFFFFFFFFFFFFFFFF FFFFFFFFFFFFFFFFF 
 FFFFFFF                  FFFFFFFFFFFFFFFFFFFFFFFFFFFFFFFFFFF FFFFFFFFF         
 FFFFFFF                  FFFFFFFFFFFFFFFFFFFFFFFFFFFFFFFFFFF FFFFFFFFF         
 FFFFFFF FFFFFFFFFFFFFF   FFFFFFFFFFFFFFFFFFFFFFFFFFFFFFFFFFF FFFFFFFFF         
 FFFFFFF FFFFFFFFFFFFFF   FFFFFFF                   FFFFFFFFF FFFFFFFFF         
 FFFFFFF FFFFFFFFFFFFFF   FFFFFFF                   FFFFFFFFF FFFFFFFFF         
 FFFFFFF FFFFFFFFFFFFFF   FFFFFFF                   FFFFFFFFF FFFFFFFFF         
 FFFFFFFFFFFFFFFFFFFFFFFFFFFFFFFFFFFFFF             FFFFFFFFF FFFFFFFFF         
 FFFFFFFFFFFFFFFFFFFFFFFFFFFFFFFFFFFFFF             FFFFFFFFF FFFFFFFFF         
 FFFFFFFFFFFFFFFFFFFFFFFFFFFFFFFFFFFFFF             FFFFFFFFF FFFFFFFFF         
 FFFFFFFFFFFFFFFFFFFFFFFFFFFFFFFFFFFFFF             FFFFFFFFF FFFFFFFFF         
 FFFFFFFFFFFFFFFFFFFFFFFFFFFFFFFFFFFFFF             FFFFFFFFF FFFFFFFFF         
 FFFFFFF FFFFFFFFFFFFFF      FFFFFFFFFF             FFFFFFFFF FFFFFFFFF         
 FFFFFFF FFFFFFFFFFFFFF      FFFFFFFFFF     FFFFFFFFFFFFFFFFF FFFFFFFFF         
 FFFFFFF FFFFFFF2FFFFFF      FFFFFFFFFF     FFFFFFFFFFFFFFFFF FFFFFFFFF         
 FFFFFFF FFFFFFFFFFFFFF      FFFFFFFFFF     FFFFFFFFFFFFFFFFF FFFFFFFFF         
 FFFFFFF                     FFFFFFFFFF     FFFFFFFFFFFFFFFFF FFFFFFFFF         
 FFFFFFF                     FFFFFFFFFF     FFFFFFFFFFFFFFFFF FFFFFFFFF         
 FFFFFFF  FFFFFFFFFFFFFFFFFFFFFFFFFFFFFFFFF        FFFFFFFFFF FFFFFFFFF         
 FFFFFFF  FFFFFFFFFFFFFFFFFFFFFFFFFFFFFFFFF FFFFFFFFFFFFFFFFF FFFFFFFFF         
 FFFFFFF  FFFFFFFFFFFFFFFFFFFFFFFFFFFFFFFFF FFFFFFFFFFFFFFFFF FFFFFFFFF         
 FFFFFFF  FFFFFFFFFFFFFFFFFFFFFFFFFFFFFFFFF F2FFFFFFFFFFFFFFF FFFFFFFFF         
 FFFFFFF  FFFFFFFFFFFFFFFFFFFFFFFFFFFFFFFFF FFFFFFFFFFFFFFFFF FFFFFFFFF         
 FFFFFFF  FFFFFFFFFFFFFFFFFFFFFFFFFFFFFFFFF FFFFFFFFFFFFFFFFF FFFFFFFFF         
 FFFFFFFF FFFFFFFFFFFFFFFFFFFFFFFFFFFFFFFFF        FFFFFFFFFF FFFFFFFFF         
 FFFFFFFF FFFFFFFFFFFFFFFFFFFFFFFFFFFFFFFFF FFFFFFFFFFFFFFFFF FFFFFFFFF         
 FFFFFFF2 FFFFFFFFFFFFFFFFFFFFFFFFFFFFFFFFF FFFFFFFFFFFFFFFFF FFFFFFFFF         
 FFFFFFFF FFFFFFFFFFFFFFFFFFFFFFFFFFFFFFFFF FFFFFFFFFFFFFFFFF FFFFFFFFF         
 FFFFFFFF FFFFFFFFFFFFFFFFFFFFFFFFFFFFFFFFF FFFFFFFFFFFFFFFFF FFFFFFFFF         
          FFFFFFFFFFFFFFFFFFFFFFFFFFFFFFFFF FFFFFFFFFFFFFFFFFFFFFFFFFFF         
          FFFFFFFFFFFFFFFFFFFFFFFFFFFFFFFFF        FFFFFFFFFFFFFFFFFFFF         
          FFFFFFFFFFFFFFFFFFFFFFFFFFFFFFFFF FFFFFFFFFFFFFFFFFFFFFFFFFFF         
          FFFFFFFFFFFFFFFFFFFFFFFFFFFFFFFF2 FFFFFFFFFFFFFFFFFF FFFFFFFF         
          FFFFFFFFFFFFFFFFFFFFFFFFFFFFFFFFF FFFFFFFFFFFFFFFFFF FFFFFFFF         
          FFFFFFFFFFFFFFFFFFFFFFFFFFFFFFFFF FFFFFFFFFFFFFFFFFF FFFFFFFF         
                 FFFFFFFFFF                                                     
                 FFFFFFFFFF                                                     
                 FFFFFFFFFF                                                     
                 FFFFFFFFFF                                                     
                 FFFFFFFFFFFFFFFFFFFFFFFFFFFFFFFFFFFFFFF                        
                 FFFFFFFFFFFFFFFFFFFFFFFFFFFFFFFFFFFFFFF                        
                 FFFFFFFFFFFFFFFFFFFFFFFFFFFFFFFFFFFFFFF                        
                 FFFFFFFFFFFFFFFFFFFFFFFFFFFFFFFFFFFFF0F                        
                 FFFFFFFFFFFFFFFFFFFFFFFFFFFFFFFFFFFFFFF                        
                 FFFFFFFFFFFFFFFFFFFFFFFFFFFFFFFFFFFFFFF                        
                 FFFFFFFFFFFFFFFFFFFFFFFFFFFFFFFFFFFFFFF                        
                                                                                