90*66
                                                                                          
                                                                   FFFFFFFFFFFFFFFFFFFFFF 
                                                                   FFFFFFFF2FFFFF2FFFFFFF 
                                                                   FFFFFFFFFFFFFFFFFFFFFF 
                                                                   FFFFFFFFFFFFFFFFFFFFFF 
                                                                   FFFFFFFFFFFFFFFFFFFFFF 
                                                                   FFFFFFFFFFFFFFFFFFFFFF 
                                                                   FFFFFFFFFFFFFFFFFFFFFF 
                                                                           FFFFFFFF       
                                                                           FFFFFFFF       
                                                                           FFFFFFFF       
     FFFFFFFFFFFFFFFFFF                                               FFFFFFFFFFFFFFFFFFF 
     FFFFFFFFFFFFFFFFFF                                               FFFFFFFFFFFFFFFFFFF 
     FFFFFFFFFFFFFFFFFF                                               FFFFFFFFFFFFFFFFFFF 
     FFFFFFFFFFFFFFFFFFFFFFFFFFFFFF  FFFFFFFFFF  FFFFFFFFFF FFFFFFFFFFFFFFFFFFFFFFFFFFFFF 
     FFFFFFFFFFFFFFFFFFFFFFFFFFFFFF  FFFFFFFFFF  FFFFFFFFFF FFFFFFFFFFFFFFFFFFFFFFFFFFFFF 
     FFFFFFFFFFFFFFFFFFFFFFFFFFFFFF  FFFFFFFFFF  FFFFFFFFFF FFFFFFFFFFFFFFFFFFFFFFFFFFFFF 
     FFFFFFFFFFFFFFFFFFFFFFFFFFFFFF  FFFFFFFFFF  FFFFFFFFFF FFFFFFFFFFFFFFFFFFFFFFFFFFFFF 
     FFFFFFFFFFFFFFFFFFFFFFFFFFFFFFFFFFFFFFFFFFFFFFFFFFFFFFFFFFFFFFFFFFFFFFFFFFFFFFFFFFFF 
     FFFFFFFFFFFFFFFFFFFFFFFFFFFFFFFFFFFFFFFFFFFFFFFFFFFFFFFFFFFFFFFFFFFFFFFFFFFFFFFFFFFF 
     FFFFFFFFFFFFFFFFFFFFFFFFFFFFFFFFFFFFFFFFFFFFFFFFFFFFFFFFFFFFFFFFFFFFFFFFFFFFFFFFFFFF 
     FFFFFFFFFFFFFFFFFFFFFFFFFFFFFFFFFFFFFFFFFFFFFFFFFFFFFFFFFFFFFFFFFFFFFFFFFFFFFFFFFFFF 
 FFFFFFFFFFFFFFFFFFFFFF                                        FFFFFFFFFFFFFFFFFFFFFFFFFF 
 FFFFFFFFFFFFFFFFFFFFFF                                        FFFFFFFFFFFFFFFFFFFFFFFFFF 
 FFFFFFFFFFFFFFFFFFFFFF FFFFFFFF FFFFFFFFF FFFFFFFFF FFFFFFFFF FFFFFFFFFFFFFFFFFFFFFFFFFF 
 F3FFFFFFFFFFFFFFFFFFFF FFFFFFFF FFFFFFFFF FFFFFFFFF FFFFFFFFF FFFFFFFFFFFFFFFFFFFFFFFFFF 
 FFFFFFFFFFFFFFFFFFFFFF FFFFFFFF FFFFFFFFF FFFFFFFFF FFFFFFFFF FFFFFFFFFFFFFFFFFFFFFFFFFF 
 FFFFFFFFFFFFFFFFFFFFFFFFFFFFFFFFFFFFFFFFFFFFFFFFFFFFFFFFFFFFFFFFFFFFFFFFFFFFFFFFFFFFFFFF 
 FFFFFFFFFFFFFFFFFFFFFFFFFFFFFFFFFFFFFFFFFFFFFFFFFFFFFFFFFFFFFFFFFFFFFFFFFFFFFFFFFFFFFFFF 
     FFFFFFFFFFFFFFFFFFFFFFFFFFFFFFFFFFFFFFFFFFFFFFFFFFFFFFFFFFFFFFFFFFFFFFFFFFFFFFFFFFFF 
     FFFFFFFFFFFFFFFFFFFFFFFFFFFFFFFFFFFFFFFFFFFFFFFFFFFFFFFFFFFFFFFFFFFFFFFFFFFFFFFFFFFF 
     FFFFFFFFFFFFFFFFFFFFFFFFF FFFFFFFFF FFFFFFFFF FFFFFFFFF FFFFFFFF FFFFFFFFFFFFFFFFFFF 
     FFFFFFFFFFFFFFFFFFFFFFFFF FFFFFFFFF FFFFFFFFF FFFFFFFFF FFFFFFFF FFFFFFFFFFFFFFFFFFF 
     FFFFFFFFFFFFFFFFFFFFFFFFF FFFFFFFFF FFFFFFFFF FFFFFFFFF FFFFFFFF FFFFFFFFFFFFFFFFFFF 
     FFFFFFFFFFFFFFFFFF                                               FFFFFFFFFFFFFFFFFFF 
     FFFFFFFFFFFFFFFFFF                                               FFFFFFFFFFFFFFFFFFF 
     FFFFFFFFFFFFFFFFFFFFFFFFFFFFFFFFFFFFFFFFFFFFFFFFFFFFFFFFFFFFFFFFFFFFFFFFFFFFFFFFFFFF 
     FFFFFFFFFFFFFFFFFFFFFFFFFFFFFFFFFFFFFFFFFFFFFFFFFFFFFFFFFFFFFFFFFFFFFFFFFFFFFFFFFFFF 
     FFFFFFFFFFFFFFFFFFFFFFFFFFFFFFFFFFFFFFFFFFFFFFFFFFFFFFFFFFFFFFFFFFFFFFFFFFFFFFFFFFFF 
     FFFFFFFFFFFFFFFFFFFFFFFFFFFFFFFFFFFFFFFFFFFFFFFFFFFFFFFFFFFFFFFFFFFFFFFFFFFFFFFFFFFF 
     FFFFFFFFFFFFFFFFFFFFFFFFFFFFFFFFFFFFFFFFFFFFFFFFFFFFFFFFFFFFFFFFFFFFFFFFFFFFFFFFFFFF 
                                                                         FFFFFFFFFFFFFFFF 
                                                                         FFFFFFFFFFFFFFFF 
 FFFFFFFFFFFFFFFFFFFFFFFFFFFFFFFFFFFFFFFFFFFFFFFFFFFFFFFFFFFFFFFFFFFFFFFFFFFFFFFFFFFFFFFF 
 FFFFFFFFFFFFFFFFFFFFFFFFFFFFFFFFFFFFFFFFFFFFFFFFFFFFFFFFFFFFFFFFFFFFFFFFFFFFFFFFFFFFFFFF 
 FFFFFFFFFFFFFFFFFFFFFFFFFFFFFFFFFFFFFFFFFFFFFFFFFFFFFFFFFFFFFFFFFFFFFFFFFFFFFFFFFFFFFFFF 
 FFFFFFFFFFFFFFFFFFFFFFFFFFFFFFFFFFFFFFFFFFFFFFFFFFFFFFFFFFFFFFFFFFFFFFFFFFFFFFFFFFFFFFFF 
 FFFFFFFFFFFFFFFFFFFFFFFFFFFFFFFFFFFFFFFFFFFFFFFFFFFFFFFFFFFFFFFFFFFFFFFFFFFFFFFFFFFFFFFF 
 FFFFFFFFFFFFFFFFFFF     FFFFFFFFFFFFFFFFFFFFFFFFFFFFFFFFFFFFF     FFFFFFFFFFFFFFFFFFFFFF 
 FFFFFFFFFFFFFFFFFFF FFFFFFFFFFFFFFFFFFFFFFFFFFFFFFFFFFFFFFFFFFFFF FFFFFFFFFFFFFFFFFFFFFF 
 FFFFFFFFFFFFFFFFFFF FFFFFFFFFFFFFFFFFFFFFFFFFFFFFFFFFFFFFFFFFFFFF FFFFFFFFFFFFFFFFFFFFFF 
 FFFFFFFFFFFFFFFFFFF FFFFFFFFFFFFFFFFFFFFFFFFFFFFFFFFFFFFFFFFFFFFF FFFFFFFFFFFFFFFFFFFFFF 
 FFFFFFFFFFFFFFFFFFF FFFFFFFFFFFFFFFFFFFFFFFFFFFFFFFFFFFFFFFFFFFFF FFFFFFFFFFFFFFFFFFFFFF 
 F0FFFFFFFFFFFFFFFFF                 FFFFFFFFFFFF                  FFFFFFFFFFFFFFFFFFFFFF 
 FFFFFFFFFFFFFFFFFFF FFFFFFFFFFFFFFFFFFFFFFFFFFFFFFFFFFFFFFFFFFFFF FFFFFFFFFFFFFFFFFFFFFF 
 FFFFFFFFFFFFFFFFFFF FFFFFFFFFFFFFFFFFFFFFFFFFFFFFFFFFFFFFFFFFFFFF FFFFFFFFFFFFFFFFFFFFFF 
 FFFFFFFFFFFFFFFFFFF FFFFFFFFFFFFFFFFFFFFFFFFFFFFFFFFFFFFFFFFFFFFF FFFFFFFFFFFFFFFFFFFFFF 
 FFFFFFFFFFFFFFFFFFF FFFFFFFFFFFFFFFFFFFFFFFFFFFFFFFFFFFFFFFFFFFFF FFFFFFFFFFFFFFFFFFFFFF 
 FFFFFFFFFFFFFFFFFFF     FFFFFFFFFFFFFFFFFFFFFFFFFFFFFFFFFFFFF     FFFFFFFFFFFFFFFFFFFFFF 
 FFFFFFFFFFFFFFFFFFFFFFFFFFFFFFFFFFFFFFFFFFFFFFFFFFFFFFFFFFFFFFFFFFFFFFFFFFFFFFFFFFFFFFFF 
 FFFFFFFFFFFFFFFFFFFFFFFFFFFFFFFFFFFFFFFFFFFFFFFFFFFFFFFFFFFFFFFFFFFFFFFFFFFFFFFFFFFFFFFF 
 FFFFFFFFFFFFFFFFFFFFFFFFFFFFFFFFFFFFFFFFFFFFFFFFFFFFFFFFFFFFFFFFFFFFFFFFFFFFFFFFFFFFFFFF 
 FFFFFFFFFFFFFFFFFFFFFFFFFFFFFFFFFFFFFFFFFFFFFFFFFFFFFFFFFFFFFFFFFFFFFFFFFFFFFFFFFFFFFFFF 
 FFFFFFFFFFFFFFFFFFFFFFFFFFFFFFFFFFFFFFFFFFFFFFFFFFFFFFFFFFFFFFFFFFFFFFFFFFFFFFFFFFFFFFFF 
 FFFFFFFFFFFFFFFFFFFFFFFFFFFFFFFFFFFFFFFFFFFFFFFFFFFFFFFFFFFFFFFFFFFFFFFFFFFFFFFFFFFFFFFF 
                                                                                          