91*81
                                                                                           
                                                                        FFFFF              
                                                                        FF0FF              
                                                                        FFFFF              
                                                                        FFFFF              
 FFFFFFFFFFFFFFFFFFFFFFFFFFFFFFFFFFFFF                FFFFFFFFFFFFFFFFFFFFFFFFFFFFFFFFFFFF 
 FFFFFFFFFFFFFFFFFFFFFFFFFFFFFFFFFFFFF                FFFFFFFFFFFFFFFFFFFFFFFFFFFFFFFFFFFF 
 FFFFFFFFFFFFFFFFFFFFFFFFFFFFFFFFFFFFF                FFFFFFFFFFFFFFFFFFFFFFFFFFFFFFFFFFFF 
 FFFFFFFFF                                            FFFFFFFFFFFFFFFFFFFFFFFFFFFFFFFFFFFF 
 FFFFFFFFF                                            FFFFFFFFFFFFFFFFFFFFFFFFFF2FFFFFFFFF 
 FFFFFFFFFFFFFFFFFFFFFFFFFFFFFFFFFFFFF                FFFFFFF      FFFFFFFFFFF      FFFFFF 
 FFFFFFFFFFFFFFFFFFFFFFFFFFFFFFFFFFFFF                FFFFFFF      FFFFFFFFFFF      FFFFFF 
 FFFFFFFFFFFFFFFFFFFFFFFFFFFFFFFFFFFFF                FFFFFFF      FFFFFFFFFFF      FFFFFF 
 FFFFFFFFFFFFFFFFFFFFFFFFFFFFFFFFFFFFF                FFFFFFF      FFFFFFFFFFF      FFFFFF 
 FFFFFFFFFFFFFFFFFFFFFFFFFFFFFFFFFFFFF                FFFFFFFFFFFFFFFFFFFFFFFFFFFFFFFFFFFF 
                             FFFFFFFFF                FFFFFFFFFFFFFFFFFFFFFFFFFFFFFFFFFFFF 
                             FFFFFFFFF                FFFFFFFFFFFFFFFFFFFFFFFFFFFFFFFFFFFF 
 FFFFFFFFFFFFFFFFFFFFFFFFFFFFFFFFFFFFF                FFFFFFFFFFFFFFFFFFFFFFFFFFFFFFFFFFFF 
 FFFFFFFFFFFFFFFFFFFFFFFFFFFFFFFFFFFFF                FFFFFFFFFFFFFFFFFFFFFFFFFFFFFFFFFFFF 
 FFFFFFFFFFFFFFFFFFFFFFFFFFFFFFFFFFFFF                FFFFFFFFFFFFFFFFFFFFFFFFFFFFFFFFFFFF 
 FFFFFFFFFFFFFFFFFFFFFFFFFFFFFFFFFFFFF                FFFFFFFFFFFFFFFFFFFFFFFFFFFFFFFFFFFF 
 FFFFFFFFFFFFFFFFFFFFFFFFFFFFFFFFFFFFF                FFFFFFFFFFFFFFFFFFFFFFFFFFFFFFFFFFFF 
 FFFFFFFFF                                            FFFFFFFFFFFFFFFFFFFFFFFFFFFFFFFFFFFF 
 FFFFFFFFF                                            FFFFFFFFFFFFFFFFFFFFFFFFFFFFFFFFFFFF 
 FFFFFFFFFFFFFFFFFFFFFFFFFFFFFFFFF2FFF                FFFFFFFFFFFFFFFFFFFFFFFFFFFFFFFFFFFF 
 FFFFFFFFFFFFFFFFFFFFFFFFFFFFFFFFFFFFF                FFFFFFFFFFFFFFFFFFFFFFFFFFFFFFFFFFFF 
 FFFFFFFFFFFFFFFFFFFFFFFFFFFFFFFFFFFFF                FFFFFFFFFFFFFFFFFFFFFFFFFFFFFFFFFFFF 
 FFFFFFFFFFFFFFFFFFFFFFFFFFFFFFFFFFFFF                FFFFFFFFFFFFFFFFFFFFFFFFFFFFFFFFFFFF 
 FFFFFFFFFFFFFFFFFFFFFFFFFFFFFFFFFFFFF                FFFFFFFFFFFFFFFFFFFFFFFFFFFFFFFFFFFF 
                             FFFFFFFFF                FFFFFFFFFFF2FFFFFFFFFFFFFFFFFFFFFFFF 
                             FFFFFFFFFFFFFFFFFFFFFFFFFFFFFFFFF      FFFFFFFFFF      FFFFFF 
 FFFFFFFFFFFFFFFFFFFFFFFFFFFFFFFFFFFFFFFFFFFFFFFFFFFFFFFFFFFFF      FFFFFFFFFF      FFFFFF 
 FFFFFFFFFFFFFFFFFFFFFFFFFFFFFFFFFFFFFFFFFFFFFFFFFFFFFFFFFFFFF      FFFFFFFFFF      FFFFFF 
 FFFFFFFFFFFFFFFFFFFFFFFFFFFFFFFFFFFFFFFFFFFFFFFFFFFFFFFFFFFFF      FFFFFFFFFF      FFFFFF 
 FFFFFFFFFFFFFFFFFFFFFFFFFFFFFFFFFFFFF                FFFFFFFFFFFFFFFFFFFFFFFFFFFFFFFFFFFF 
 FFFFFFFFFFFFFFFFFFFFFFFFFFFFFFFFFFFFF                FFFFFFFFFFFFFFFFFFFFFFFFFFFFFFFFFFFF 
 FFFFFFFFFFFFFFFFFFFFFFFFFFFFFFFFFFFFF                FFFFFFFFFFFFFFFFFFFFFFFFFFFFFFFFFFFF 
 FFFFFFFFFFFFFFFFFFFFFFFFFFFFFFFFFFFFF                FFFFFFFFFFFFFFFFFFFFFFFFFFFFFFFFFFFF 
                FFFF                                                           FFFFFFFFFFF 
                FFFF                                                           FFFFFFFFFFF 
                FFFF                                                                       
                FFFF                                                                       
                FFFF                                                                       
                FFFF                                                                       
                FFFF                                                                       
                FFFF                                                           FFFFFFFFFFF 
                FFFF                                                           FFFFFFFFFFF 
 FFFFFFFFFFFFFFFFFFFFFFFFFFFFFFFFFFF           FFFFFFFFFFFFFFF FFFFFFFFFFFFFFFFFFFFFFFFFFF 
 FFFFFFFFFFFFFFFFFFFFFFFFFFFFFFFFFFF FFFF2FFF  FFFFFFFFFFFFFFF FFFFFFFFFFFFFFFFFFFFFFFFFFF 
 FFFFFFFFFFFFFFFFFFFFFFFFFFFFFFFFFFF FFFFFFFF  FFFFFFFFFFFFFFF FFFFFFFFFFFFFFFFFFFFFFFFFFF 
                       FFFFFFFFFFFFF FFFFFFFF  FFFFFFFFFFFFFFFFFFFFFFFFFFFFFFFFFFFFFFFFFFF 
 FFFFFFFFFFFFFFFFFFFFFFFFFFFFFFFFFFFFFFFFFFFF  FFFFFFFFFFFFFFFFFFFFFFFFFFFFFFFFFFFFFFFFFFF 
 FFFFFFFFFFFFFFFFFFFFFFFFFFFFFFFFFFFFFFFFFFFF  FFFFFFFFFFFFFFFFFFFFFFFFFFFFFFFFFFFFFFFFFFF 
 FFFFFFFFFFFFFFFFFFFFFFFFFFFFFFFFFFFFFFFFFFFF  FFFFFFFFFFFFFFF FFFFFFFFFFFFFFFFFFFFFFFFFFF 
 FFFFFFFFFFFFFFFFFFFFFFFFFFFFFFFFFFF FFFFFFFF  FFFFFFFFFFFFFFF FFFFFFFFFFFFFFFFFFFFFFFFFFF 
 FFFFFFFFFFFFFFFFFFFFFFFFFFFFFFFFFFF FFFFFFFF  FFFFFFFFFFFFFFF FFFFFFFFFFFFFFFFFFFFFFFFFFF 
 FFFFFFF                                                                     FFFFFFFFFFFFF 
 FFFFFFF                                                                     FFFFFFFFFFFFF 
 FFFFFFF                                                                     FFFFFFFFFFFFF 
 FFFFFFF                                                                     FFFFFFFFFFFFF 
 FFFFFFFFFFFFFFFFFFFFFFFFFFFFFFFFFFFF FFFFFFFFFFFFFFFFFFFFFFFFFFFFFFFFFFFFFFFFFFFFFFFFFFFF 
 FFFFFFFFFFFFFFFFFFFFFFFFFFFFFFFFFFFF FFFFFFFFFFFFFFFFFFFFFFFFFFFFFFFFFFFFFFFFFFFFFFFFFFFF 
 FFFFFFFFFFFFFFFFFFFFFFFFFFFFFFFFFFFF FFFFFFFFFFFFFFFFFFFFFFFFFFFFFFFFFFFFFFFFFFFFFFFFFFFF 
 FFFFFFFFFFFFFFFFFFFFFFFFFFFFFFFFFFFFFFFFFFFFFFFFFFFFFFFFFFFFFFFFFFFFFFFFFFFFFFFFFFFFFFFFF 
 FFFFFFFFFFFFFFFFFFFFFFFFFFFFFFFFFFFFFFFFFFFFFFFFFFFFFFFFFFFFFFFFFFFFFFFFFFFFFFFFFFFFFFFFF 
 FFFFFFFFFFFFFFFFFFFFFFFFFFFFFFFFFFFFFFFFFFFFFFFFFFFFFFFFFFFFFFFFFFFFFFFFFFFFFFFFFFFFFFFFF 
 FFFFFFFFFFFFFFFFFFFFFFFFFFFFFFFFFFFF FFFFFFFFFFFFFFFFFFFFFFFFFFFFFFFFFFFFFFFFFFFFFFFFFFFF 
 FFFFFFFFFFFFFFFFFFFFFFFFFFFFFFFFFFFF FFFFFFFFFFFFFFFFFFFFFFFFFFFFFFFFFFFFFFFFFFFFFFFFFFFF 
 FFFFFFFFFFFFFFFFFFFFFFFFFFFFFFFFFFFF                        FFFFFFFFFFFFFFFFFFFFFFFFFFFFF 
 FFFFFFFFFFFFFFFFFFFFFFFFFFFFFFFFFFFF FFFFFFFFFFFFF FFFFFFFFFFFFFFFFFFFFFFFFFFFFFFFFFFFFFF 
 FFFFFFFFFFFFFFFFFFFFFFFFFFFFFFFFFFFF FFFFFFFFFFFFF FFFFFFFFFFFFFFFFFFFFFFFFFFFFFFFFFFFFFF 
 FFFFFFFFFFFFFFFFFFFFFFFFFFFFFFFFFFFF FFFFFFFFFFFFFFFFFFFFFFFFFFFFFFFFFFFFFFFFFFFFFFFFFFFF 
 FFFFFFFFFFFFFFFFFFFFFFFFFFFFFFFFFFFF FFFFFFFFFFFFFFFFFFFFFFFFFFFFFFFFFFFFFFFFFFFFFFFFFFFF 
 FFFFFFFFFFFFFFFFFFFFFFFFFFFFFFFFFFFF FFFFFFFFFFFFFFFFFFFFFFFFFFFFFFFFFFFFFFFFFFFFFFFFFFFF 
 FFFFFFFFFFFFFFFFFFFFFFFFFFFFFFFFFFFF FFFFFFFFFFFFF FFFFFFFFFFFFFFFFFFFFFFFFFFFFFFFFFFFFFF 
 FFFFFFFFFFFFFFFFFFFFFFFFFFFFFFFFFFFF FFFFFFFFFFFFF FFFFFFFFFFFFFFFFFFFFFFFFFFFFFFFFFFFFFF 
                                          FFFFF                                            
                                          FFFFF                                            
                                          FF3FF                                            
                                          FFFFF                                            
                                                                                           