100*78
                                                                                                    
                                          FFFFF                                                     
                                      FFFFFF0FFFFFF                                                 
                                      FFFFFFFFFFFFF                                                 
                                      FFFFFFFFFFFFF                                                 
    FFFFFFFFFFFFFFFFFFFFFFFFFFFFFFFFFFFFFFFF2FFFFFF                                                 
    FFFFFFFFFFFFFFFFFFFFFFFFFFFFFFFFFFFFFFFFFFFFFFF                                                 
    FFFFFFFFFFFFFFFFFFFFFFFFFFFFFFFFFFFFFFFFFFFFFFF                                                 
    FFFF                              FFFFFFFFFFFFF                                                 
    FFFF                                                                                            
    FFFF                                                                                            
    FFFF                                                FFFFFFFFFFFFFFFFFFFFFFFFFFFFFFFFFFFFFFFFFFF 
    FFFF                                                FFFFFFFFFFFFFFFFFFFFFFFFFFFFFFFFFFFFFFFFFFF 
    FFFF                                                FFFFFFFFFFFFFFFFFFFFFFFFFFFFFFFFFFFFFFFFFFF 
    FFFF                                                FFFFFFFFFFFFFFFFFFFFFFFFFFFFFFFFFFFFFFFFFFF 
 FFFFFFFFFFFFFFFFFFFFFFFFF            FFFFFFFFFFFFF     FFFFFFFFFFFFFFFFFFFFFFFFFFFFFFFFFFFFFFFFFFF 
 FFFFFFFFFFFFFFFFFFFFFFFFF            FFFFFFFFFFFFF     FFFFFFFFFFFFFFFFFFFFFFFFFFFFFFFFFFFFFFFFFFF 
 FFFFFFFFFFFFFFFFFFFFFFFFF            FFFFFFFFFFFFF     FFFFFFFFFFFFFFFFFFFFFFFFFFFFFFFFFFFFFFFFFFF 
 FFFFFFFFFFFFFFFFFFFFFFFFF            FFFFFFFFFFFFF     FFFFFFFFFFFFFF                FFFFFFFFFFFFF 
 FFFFFFFFFFF FFFFFFFFFFFFFFFFFFFFFFFFFFFFFFFFFFFFFF     FFFFFFFFFFFFFFFFFFFFFFFFFFFFFFFFFFFFFFFFFFF 
 FFFFFFFFFFF FFFFFFFFFFFFFFFFFFFFFFFFFFFFFFFFFFFFFF     FFFFFFFFFFFFFFFFFFFFFFFFFFFFFFFFFFFFFFFFFFF 
 FFFFFFFFFFF FFFFFFFFFFFFFFFFFFFFFFFFFFFFFFFFFFFFFF     FFFFFFFFFFFFFFFFFFFFFFFFFFFFFFFFFFFFFFFFFFF 
 FFFFFFFFFFF FFFFFFFFFFFFF            FFFFFFFFFFFFF     FFFFFFFFFFFFFFFFFFFFFFFFFFFFFFFFFFFFFFFFFFF 
 FFFFFFFFFFF FFFFFFFFFFFFF            FFFFFFFFFFFFF     FFFFFFFFFFFFFFFFFFFFFFFFFFFFFFFFFFFFFFFFFFF 
 FFFFFFFFFFF FFFFFFFFFFFFF            FFFFFFFFFFFFF     FFFFFFFFFFFFFFFFFFFFF FFFFFFFFFFFFFFFFFFFFF 
 FFFFFFFFFFF FFFFFFFFFFFFF            FFFFFFFFFFFFF     FFFFFFFFFFFFFFFFFFF     FFFFFFFFFFFFFFFFFFF 
 FFFFFFFFFFF FFFFFFFFFFFFF            FFFFFFFFFFFFF     FFFFFFFFFFFFFFFF           FFFFFFFFFFFFFFFF 
 FFFFFFFFFFF FFFFFFFFFFFFF            FFFFFFFFFFFFF     FFFFFFFFFFFFF                 FFFFFFFFFFFFF 
 FFFFFFFFFFF FFFFFFFFFFFFF            FFFFFFFFFFFFF     FFFFFFFFFF                       FFFFFFFFFF 
 FFFFFFFFFFF FFFFFFFFFFFFF            FFFFFFFFFFFFF     FFFFFFFFFF                       FFFFFFFFFF 
 FFFFFFFFFFF FFFFFFFFFFFFF            FFFFFFFFFFFFF     FFFFFFFFFF                       FFFFFFFFFF 
 FFFFFFFFFFF FFFFFFFFFFFFF            FFFFFFFFFFFFF     FFFFFFFFFF                       FFFFFFFFFF 
 FFFFFFFFFFF FFFFFFFFFFFFF            FFFFFFFFFFFFF     FFFFFFFFFF                       FFFFFFFFFF 
 FFFFFFFFFFF FFFFFFFFFFFFF            FFFFFFFFFFFFF     FFFFFFFFFF                       FFFFFFFFFF 
 FFFFFF                               FFFFFFFFFFFFF     FFFFFFFFFF                       FFFFFFFFFF 
 FFFFFFFFFFFFFFFFFFFFFFFFF            FFFFFFFFFFFFF     FFFFFFFFFF                       FFFFFFFFFF 
 FFFFFFFFFFFFFFFFFFFFFFFFF            FFFFFFFFFFFFF     FFFFFFFFFF                       FFFFFFFFFF 
 FFFFFFFFFFFFFFFFFFFFFFFFF            FFFFFFFFFFFFF     FFFFFFFFFF                       FFFFFFFFFF 
 FFFFFFFFFFFFFFFFFFFFFFFFF            FFFFFFFFFFFFF     FFFFFFFFFF                       FFFFFFFFFF 
 FFFFFFFFFFFFFFFFFFFFFFFFF            FFFFFFFFFFFFF     FFFFFFFFFF                       FFFFFFFFFF 
          FFFF                        FFFFFFFFFFFFF     FFFFFFFFFF                       FFFFFFFFFF 
 FFFFFFFFFFFFFFFFFFFFFFFFF            FFFFFFFFFFFFF     FFFFFFFFFF                       FFFFFFFFFF 
 FFFFFFFFFFFFFFFFFFFFFFFFF            FFFFFFFFFFFFF     FFFFFFFFFFFFF                 FFFFFFFFFFFFF 
 FFFFFFFFFFFFFFFFFFFFFFFFF            FFFFFFFFFFFFF     FFFFFFFFFFFFFFFF           FFFFFFFFFFFFFFFF 
 2FFFFFFFFFFFFFFFFFFFFFFF2            FFFFFFFFFFFFF     FFFFFFFFFFFFFFFFFFF     FFFFFFFFFFFFFFFFFFF 
 FFFFFFFFFFFFFFFFFFFFFFFFF            FFFFFFFFFFFFF     FFFFFFFFFFFFFFFFFFFFF FFFFFFFFFFFFFFFFFFFFF 
 FFFFFFFFFFFFFFFFFFFFFFFFF            FFFFFFFFFFFFF     FFFFFFFFFFFFFFFFFFFFFFFFFFFFFFFFFFFFFFFFFFF 
 FFFFFFFFFFFFFFFFFFFFFFFFF            FFFFFFFFFFFFF     FFFFFFFFFFFFFFFFFFFFFFFFFFFFFFFFFFFFFFFFFFF 
 FFFFFFFFFFFFFFFFFFFFFFFFF            FFFFFFFFFFFFF     FFFFFFFFFFFFFFFFFFFFFFFFFFFFFFFFFFFFFFFFFFF 
 FFFFFFFFFFFFFFFFFFFFFFFFF            FFFFFFFFFFFFF     FFFFFFFFFFFFFFFFFFFFFFFFFFFFFFFFFFFFFFFFFFF 
 FFFFFFFFFFFFFFFFFFFFFFFFF            FFFFFFFFFFFFF     FFFFFFFFFFFFFFFFFFFFFFFFFFFFFFFFFFFFFFFFFFF 
 FFFFFFFFFFFFMFFFFFFFFFFFF            FFFFFFFFFFFFF     FFFFFFFFFFFFFFFFFFFFFFFFFFFFFFFFFFFFFFFFFFF 
 FFFFFFFFFFFFFFFFFFFFFFFFF            FFFFFFFFFFFFF     FFFFFFFFFFFFFFFFFFFFFFFFFFFFFFFFFFFFFFFFFFF 
 FFFFFFFFFFFFFFFFFFFFFFFFF            FFFFFFFFFFFFF     FFFFFFFFFFFFFFFFFFFFFFFFFFFFFFFFFFFFFFFFFFF 
 FFFFFFFFFFFFFFFFFFFFFFFFF            FFFFFFFFFFFFF     FFFFFFFFFFFFFFFFFFFFFFFFFFFFFFFFFFFFFFFFFFF 
 FFFFFFFFFFFFFFFFFFFFFFFFF            FFFFFFFFFFFFF     FFFFFFFFFFFFFFFFFFFFFFFFFFFFFFFFFFFFFFFFFFF 
 FFFFFFFFFFFFFFFFFFFFFFFFF            FFFFFFFFFFFFF               FFFFFFFFFFFFFFFFFFFFFFFF          
 FFFFFFFFFFFFFFFFFFFFFFFFF            FFFFFFFFFFFFF     FFFFFFFFFFFFFFFFFFFFFFFFFFFFFFFFFFFFFFFFFFF 
 FFFFFFFFFFFFFFFFFFFFFFFFF            FFFFFFFFFFFFF     FFFFFFFFFFFFFFFFFFFFFFFFFFFFFFFFFFFFFFFFFFF 
 FFFFFFFFFFFFFFFFFFFFFFFFF            FFFFFFFFFFFFF     FFFFFFFFFFFFFFFFFFFFFFFFFFFFFFFFFFFFFFFFFFF 
 FFFFFFFFFFFFFFFFFFFFFFFFF            FFFFFFFFFFFFF     FFFFFFFFFFFFFFFFFFFFFFFFFFFFFFFFFFFFFFFFFFF 
 FFFFFFFFFFFFFFFFFFFFFFFFF            FFFFFFFFFFFFF     FFFFFFFFFFFFFFFFFFFFFFFFFFFFFFFFFFFFFFFFFFF 
 FFFFFFFFFFFFFFFFFFFFFFFFF            FFFFFFFFFFFFF     FFFFFFFFFFFFFFFFFFFFFFFFFFFFFFFFFFFFFFFFFFF 
 FFFFFFFFFFFFFFFFFFFFFFFFF            FFFFFFFFFFFFF     FFFFFFFFFFFFFFFFFFFFFFFFFFFFFFFFFFFFFFFFFFF 
 FFFFFFFFFFFFFFFFFFFFFFFFF            FFFFFFFFFFFFF     FFFFFFFFFFFFFFFFFFFFFFFFFFFFFFFFFFFFFFFFFFF 
 FFFFFFFFFFFFFFFFFFFFFFFFF            FFFFFFFFFFFFF                        FFFFFF                   
 FFFFFFFFFFFFFFFFFFFFFFFFF            FFFFFFFFFFFFF                        FFFFFF                   
 FFFFFFFFFFFFFFFFFFFFFFFFF            FFFFFFFFFFFFF                        FFFFFF                   
 FFFFFFFFFFFFFFFFFFFFFFFFF            FFFFFFFFFFFFF                        FFFFFF                   
 FFFFFFFFFFFFFFFFFFFFFFFFF            FFFFFFFFFFFFFFFFFFFFFFFFFFFFFFFFFFFFFFFFFFFFFFFFFFFFFFFFFFFFF 
 FFFFFFFFFFFFFFFFFFFFFFFFF            FFFFFFFFFFFFFFFFFFFFFFFFFFFFFFFFFFFFFFFFFFFFFFFFFFFFFFFFFFFFF 
 FFFFFFFFFFFFFFFFFFFFFFFFF            FFFFFFFFFFFFFFFFFFFFFFFFFFFFFFFFFFFFFFFFFFFFFFFFFFFFFFFFFFFFF 
 FFFFFFFFFFFFFFFFFFFFFFFFF            FFFFFFFFFFFFFFFFFFFFFFFFFFFFFFFFFFFFFFFFFFFFFFFFFFFFFFFFFFFFF 
 FFFFFFFFFFFFFFFFFFFFFFFFF            FFFFFFFFFFFFFFFFFFFFFFFFFFFFFFFFFFFFFFFFFFFFFFFFFFFFFFFFFFFFF 
                                          FFFFF                                                     
                                          FF3FF                                                     
                                          FFFFF                                                     
                                                                                                    