33*39
                                 
 FFFFFFFFFFFFFFFFFFFFFFFFFFFFFFF 
 FFFFFFFFFFFFFFF0FFFFFFFFFFFFFFF 
 FFFFFFFFFFFFFFFFFFFFFFFFFFFFFFF 
 FFFFFFFFFFFFFFFFFFFFFFFFFFFFFFF 
 FFFFFFFFFFFFFFFFFFFFFFFFFFFFFFF 
 FFFFFFFFFFFFFFFFFFFFFFFFFFFFFFF 
 FFFFFFFFFFFFFFFFFFFFFFFFFFFFFFF 
            FFFFFFFFF            
            FFFFFFFFF            
            FFFFFFFFF            
 FFFFFFFFFFFFFFFFFFFFFFFFFFFFFFF 
 FFFFFFFFFFFFFFFFFFFFFFFFFFFFFFF 
 FFFFFFFFFFFFFFFFFFFFFFFFFFFFFFF 
 FFFFFFFFFFFFFFFFFFFFFFFFFFFFFFF 
 FFFFFFFFFFFFFFFFFFFFFFFFFFFFFFF 
 FFFFFFFFFFFFFFFFFFFFFFFFFFFFFFF 
 FFFFFFFFFFFFFFFFFFFFFFFFFFFFFFF 
 FFFFFFFFFFFFFFFFFFFFFFFFFFFFFFF 
 FFFFFFFFFFFFFFFFFFFFFFFFFFFFFFF 
            FFFFFFFFF            
            FFFFFFFFF            
            FFFFFFFFF            
            FFFFFFFFF            
 FFFFFFFFFFFFFFFFFFFFFFFFFFFFFFF 
 FFFFFFFFFFFFFFFFFFFFFFFFFFFFFFF 
 FFFFFFFFFFFFFFFFFFFFFFFFFFFFFFF 
 FFFFFFFFFFFFFFFFFFFFFFFFFFFFFFF 
 FFFFFFFFFF2FFFF2FFFF2FFFFFFFFFF 
 FFFFFFFFFFFFFFFFFFFFFFFFFFFFFFF 
 FFFFFFFFFFFFFFFFFFFFFFFFFFFFFFF 
 FFFFFFFFFFFFFFFFFFFFFFFFFFFFFFF 
 FFFFFFFFFFFFFFFFFFFFFFFFFFFFFFF 
            FFFFFFFFF            
            FFFFFFFFF            
            FFFFFFFFF            
            FFFF3FFFF            
            FFFFFFFFF            
                                 