104*71
                                                                                                        
                                      FFFFFFFF FFFFFFFFFFFFFFFFFFFFFFFFFFFFFF FFFFFFFFFF FFFFFFFFFFF    
                                      FFFFFFFF FFFFFFFFFFFFFFFFFFFFFFFFFFFFFF FFFFFFFFFF FFFFFFFFFFF    
                                      FFFFFFFFFFFFFFFFFFFFFFFFFFFFFFFFFFFFFFF FFFFFFFFFF FFFFFFFFFFF    
                                      FFFFFFFFFFFFFFFFFFFFFFFFFFFFFFFFFFFFFFFFFFFFFFFFFFFFFFFFFFFFFF    
                                      FFFFFFFFFFFFFFFFFFFFFFFFFFFFFFFFFFFFFFFFFFFFFFFFFFFFFFFFFFFFFF    
                                      FFFFFFFF FFFFFFFFFFFFFFFFFFFFFFFFFFFFFFFFFFFFFFFFFFFFFFFFFFFFF    
                                      FFFFFFFF FFFFFFFFFFFFFFFFFFFFFFFFFFFFFF FFFFFFFFFF FFFFFFFFFFF    
   FFFFFFFFFF2FFFFFFFFFFF             FFFFFFFF FFFFFFFFFFFFFFFFFFFFFFFFFFFFFF FFFFFFFFFF FFFFFFFFFFF    
   FFFFFFFFFFFFFFFFFFFFFF             FFFFFFFF FFFFFFFFFFFFFFFFFFFFFFFFFFFFFF FFFFFFFFFF FFFFFFFFFFF    
   FFFFFFFFFFFFFFFFFFFFFF             FFFFFFFF FFFFFFFF                                  FFFFFFFFFFF    
   FFFFFFFFFFFFFFFFFFFFFF                      FFFFFFFFFFFFFFFFFFFFFFFFFFFFFFFFFFFFFFFFF                
   FFFFFFFFFFFFFFFFFFFFFF             FFFFFFFFFFFFFFFFFFFFFFFFFFFFFFFFFFFFFFFFFFFFFFFFFF FFFFFFFFFFF    
   FFFFFFFFFFFFFFFFFFFFFF             FFFFFFFFFFFFFFFFFFFFFFFFFFFFFFFFFFFFFFFFFFFFFFFFFFFFFFFFFFFFFF    
   FFFFFFFFFFFFFFFFFFFFFF             FFFFFFFFFFFFFFFFFFFFFFFFFFFFFFFFFFFFFFFFFFFFFFFFFFFFFFFFFFFFFF    
   FFFFFFFFFFFFFFFFFFFFFFFFFFFFFFFFFFFFFFFFFFFFFFFFFFFFFFFFFF                FFFFFFFFFFFFFFFFFFFFFFF    
   FFFFFFFFFFFFFFFFFFFFFFFFFFFFFFFFFFFFFFFFFFFFFFFFFFFFFFFFFF FFFFFFFFFFFFFFFFFFFFFFFFFF FFFFFFFFFFF    
   FFFFFFFFFFFFFFFFFFFFFFFFFFFFFFFFFFFFFFFFFFFFFFFFFFFFFFFFFF FFFFFFFFFFFFFFFFFFFFFFFFFF FFFFFFFFFFF    
   FFFFFFFFFFFFFFFFFFFFFF             FFFFFFFFFFFFFFFFFFFFFFF FFFFFFFFFFFFFFFFFFFFFFFFFF FFFFFFFFFFF    
   FFFFFFFFFFFFFFFFFFFFFF             FFFFFFFFFFFFFFFFFFFFFFF FFFFFFFFFFFFFFFFFFFFFFFFFF FFFFFFFFFFF    
   FFFFFFFFFFFFFFFFFFFFFF                                                                        FFF    
   FFFFFFFFFFFFFFFFFFFFFF                                                                        FFF    
   FFFFFFFFFFFFFFFFFFFFFFFFFFFFFFFFFFFFF                                                         FFF    
   FFFFFFFFFFFFFFFFFFFFFFFFFFFFFFFFFFFFF                                                         FFF    
   FFFFFFFFFFFFFFFFFFFFFFFFFFFFFFFFFFFFF                                             FFFFFFFFF FFFFFFF  
                                    FFFF                                             FFFFFFFFF FFFFFFF  
                                    FFFF                                             2FFFFFFFFFFFFFFFF  
                                    FFFF                                             FFFFFFFFFFFFFFFFF  
                                 FFFFFFFFFFFFFFFFFFFFFFFFFFFFFF                      FFFFFFFFFFFFFFFFF  
                                 FFFFFFFFFFFFFFFFFFFFFFFFFFFFFF                      FFFFFFFFF FFFFFFF  
                                 FFFFFFFFFFFFFFFFFFFFFFFFFFFFFF                      FFFFF2FFF FFFFFFF  
                                 FFFFFF                FFFFFFFF                                FFFFFFF  
                                 FFFFFFFFFFFFFFFFFFFFF FFFFFFFF                      FFFFFFFFFFFFFFFFF  
    FFFFFFF2FFFFFFF              FFFFFFFFFFFFFFFFFFFFF FFFFFFFF                      FFFFFFFFFFFFFFFFF  
    FFFFFFFFFFFFFFF              FFFFFFFFFFFFFFFFFFFFF FFFFFFFF                      FFFFFFFFFFFFFFFFF  
    FFFFFFFFFFFFFFF              FFFFFF        FFFFFFF FFFFFFFF                      FFFFFFFFF FFFFFFF  
    FFFFFFFFFFFFFFFFFFFFFFFFFFFFFFFFFFF FFFFFFFFFFFFFF FFFFFFFF                      FFFFFFFFF FFFFFFF  
    F0FFFFFFFFFFFFFFFFFFFFFFFFFFFFFFFFF FFFFFFFFFFFFFF FFFFFFFF                      FFFFFFFFF FFFFFFF  
    FFFFFFFFFFFFFFFFFFFFFFFFFFFFFFFFFFF FFFFF3FFFFFFFF FFFFFFFF                      FFFFFFFFF FFFFFFF  
    FFFFFFFFFFFFFFF              FFFFFF FFFFFFFFFFFFFF FFFFFFFF                      2FFFFFFFF FFFFFFF  
    FFFFFFFFFFFFFFF              FFFFFF FFFFFFFFFFFFFF FFFFFFFF                      FFFFFFFFF FFFFFFF  
    FFFFFFFFFFFFFFF              FFFFFF                FFFFFFFF                                FFFFFFF  
                                 FFFFFFFFFFFF FFFFFFFFFFFFFFFFF                      FFFFFFFFFFFFFFFFF  
                                 FFFFFFFFFFF2 FFFFFFFFFFFFFFFFF                      FFFFFFFFFFFFFFFFF  
                                 FFFFFFFFFFFF FFFFFFFFFFFFFFFFF                      FFFFFFFFFFFFFFFFF  
                                                                                                FFF     
                                                                                                FFF     
                                                                                                FFF     
                                                                                                FFF     
                                                                                                FFF     
 FFFFFFFFFFFFFFFFFFFFFFFFFFFF                                                                   FFF     
 FFFFFFFFFFFFFFFFFFFFFFFFFFFF                         FFFFFF FFFFFFFFFFFFFFFFFFFFFFFFFFFFFFFFFFFFFFFFFF 
 FFFFFFFFFFFFFFFFFFFFFFFFFFFF                         FFFFFF FFFFFFFFFFFFFFFFFFFFFFFFFFFFFFFFFFFFFFFFFF 
                      FFFFFFF                         FFFFFF FFFFFFFFFFFFFFFFFFFFFFFFFFFFFFFFFFFFFFFFFF 
 FFFFFFFFFFFFFFFFFFFFFFFFFFFF                         FFFFFF FFFFFFFFF                         FFFFFFFF 
 FFFFFFFFFFFFFFFFFFFFFFFFFFFF                         FFFFFF FFFFFFFFF                         FFFFFFFF 
 FFFFFFFFFFFFFFFFFFFFFFFFFFFF                         FFFFFF FFFFFFFFFFFFFFFFFFFFFFFFFFFFFFFFFFFFFFFFFF 
 FFFFFFFFFFFFFFFFFFFFF                                FFFFFFFFFFFFFFFFFFFFFFFFFFFFFFFFFFFFFFFFFFFFFFFFF 
 FFFFFFFFFFFFFFFFFFFFF FFFFFF                         FFFFFFFFFFFFFFFFFFFFFFFFFFFFFFFFFFFFFFFFFFFFFFFFF 
 FFFFFFFFFFFFFFFFFFFFF FFFFFF                         FFFFFFFFFFFFFFFF                         FFFFFFFF 
 FFFFFFFFFFFFFFFFFFFFF FFFFFF                         FFFFFFFFFFFFFFFF                         FFFFFFFF 
 FFFFFFFFFFFFFFFFFFFFF FFFFFF                         FFFFFFFFFFFFFFFFFFFFFFFFFFFFFFFFFFFFFFFFFFFFFFFFF 
 FFFFFFFFFFFFFFFFFFFFF FFFFFF                         FFFFFFFFFFFFFFFFFFFFFFFFFFFFFFFFFFFFFFFFFFFFFFFFF 
 FFFFFFFFFFFFFFFFFFFFF FFFFFF                         FFFFFFFFFFFFFFFFFFFFFFFFFFFFFFFFFFFFFFFFFFFFFFFFF 
 FFFFFFFFFFFFFFF2FFFFF FFFFFF                         FFFFFF FFFFFFFFFFFFFFFFFFFFFFFFFFFFFFFFFFFFFFFFFF 
 FFFFFF                FFFFFFFFFFFFFFFFFFFFFFFFFFFFFFFFFFFFF FFFFFFFFF                         FFFFFFFF 
 FFFFFFFFFFFFFFFFFFFFFFFFFFFFFFFFFFFFFFFFFFFFFFFFFFFFFFFFFFF FFFFFFFFF                         FFFFFFFF 
 FFFFFFFFFFFFFFFFFFFFFFFFFFFFFFFFFFFFFFFFFFFFFFFFFFFFFFFFFFF FFFFFFFFFFFFFFFFFFFFFFFFFFFFFFFFFFFFFFFFFF 
 FFFFFFFFFFFFFFFFFFFFFFFFFFFF                         FFFFFF FFFFFFFFFFFFFFFFFFFFFFFFFFFFFFFFFFFFFFFFFF 
 FFFFFFFFFFFFFFFFFFFFFFFFFFFF                         FFFFFF FFFFFFFFFFFFFFFFFFFFFFFFFFFFFFFFFFFFFFFFFF 
                                                                                                        