66*71
                                                                  
                          FFFFFFFFFFFFFFFFFFFFFFFFFFFFF           
                          FFFFFFFFFFFFFFF0FFFFFFFFFFFFF           
                          FFFFFFFFFFFFFFFFFFFFFFFFFFFFF           
                          FFFFFFFFFFFFFFFFFFFFFFFFFFFFF           
                          FFFFFFFFFFFFFFFFFFFFFFFFFFFFF           
                          FFFFFFFFFFFFFFFFFFFFFFFFFFFFF           
                          FFFFFFFFFFFFFFFFFFFFFFFFFFFFF           
                                     FFFFFFFF                     
                                     FFFFFFFF                     
                                     FFFFFFFF                     
                                     FFFFFFFF                     
                                     FFFFFFFF                     
                           FFFFFFFFFFFFFFFFFFFFFFFFFFFF           
                           FFFFFFFFFFFFFFFFFFFFFFFFFFFF           
                           FFFFFFFFFFFFFFFFFFFFFFFFFFFF           
                           FFFFFFFFFFFFFFFFFFFFFFFFFFFF           
                           FFFFFFFFFFFFFFFFFFFFFFFFFFFF           
                           FFFFFFFFFFFFFFFFFFFFFFFFFFFF           
            FFFFFFFFFFFFFFFFFFFFFFFFFFFFFFFFFFFFFFFFFFFFFFFFFFFFF 
            FFFFFFFFFFFFFFFFFFFFFFFFFFFFFFFFFFFFFFFFFFFFFFFFFFFFF 
            FFFFFFFFFFFFFFFFFFFFFFFFFFFFFFFFFFFFFFFFFFFFFFFFFFFFF 
            FFFFFFFFFFFFFFFFFFFFFFFFFFFFFFFFFFFFFFFFFFFFFFFFFFFFF 
            FFFFFFFFFFFFFFFFFFFFFFFFFFFFFFFFFFFFFFFFFFFFFFFFFFFFF 
            FFFFFFFFFFFFFFFFFFFFFFFFFFFFFFFFFFFFFFFFFFFFFFFFFFFFF 
            FFFFFFFFFFFFFFFFFFFFFFFFFFFFFFFFFFFFFFFFFFFFFFFFFFFFF 
            FFFFFFFFFFFFFFFFFF      FFF                FFFFFFFFFF 
            FFFFFFFFFFFFFFFFFF    FFFFFFFF FFFFFFF     FFFFFFFFFF 
            FFFFFFFFFFFFFFFFFF    FFFFFFFF FFFFFFF     FFFFFFFFFF 
            FFFFFFFFFFFFFFFFFF    FFFFFFFFFFFFFF2F     FFFFFFFFFF 
 FFFFFFFFF  FFFFFFFFFFFFFFFFFF    FFFFFFFFFFFFFFFF     FFFFFFFFFF 
 FFFFFFFFF  FFFFFFFFFFFFFFFFFF    FFFFFFFF FFFFFFF     FFFFFFFFFF 
 FFFFFFFFF  FFFFFFFFFFFFFFFFFF    FFFFFFFF FFFFFFF     FFFFFFFFFF 
 FFFFFFFFF  FFFFFFFFFFFFFFFFFF    FFFFFFFF FFFFFFF     FFFFFFFFFF 
 FFFFFFFFF  FFFFFFFFFFFFFFFFFF                         FFFFFFFFFF 
 FFFFFFFFF  FFFFFFFFFFFFFFFFFF                         FFFFFFFFFF 
 FFFFFFFFFFFFFFFFFFFFFFFFFFFFF                         FFFFFFFFFF 
 F2FFFFFFFFFFFFFFFFFFFFFFFFFFF                         FFFFFFFFFF 
 FFFFFFFFFFFFFFFFFFFFFFFFFFFFF                         FFFFFFFFFF 
 FFFFFFFFF  FFFFFFFFFFFFFFFFFF                         FFFFFFFFFF 
            FFFFFFFFFFFFFFFFFF                         FFFFFFFFFF 
            FFFFFFFFFFFFFFFFFF                         FFFFFFFFFF 
            FFFFFFFFFFFFFFFFFF                         FFFFFFFFFF 
            FFFFFFFFFFFFFFFFFF                         FFFFFFFFFF 
 FFFFFFFFF  FFFFFFFFFFFFFFFFFF                         FFFFFFFFFF 
 FFFF2FFFF  FFFFFFFFFFFFFFFFFF                         FFFFFFFFFF 
 FFFFFFFFF  FFFFFFFFFFFFFFFFFF                         FFFFFFFFFF 
 FFFFFFFFF  FFFFFFFFFFFFFFFFFF                         FFFFFFFFFF 
 FFFFFFFFF  FFFFFFFFFFFFFFFFFF                         FFFFFFFFFF 
 FFFFFFFFFFFFFFFFFFFFFFFFFFFFFFFFFFFFFFFFFFFFFFFFFFFFFFFFFFFFFFFF 
 FFFFFFFFFFFFFFFFFFFFFFFFFFFFFFFFFFFFFFFFFFFFFFFFFFFFFFFFFFFFFFFF 
 FFFFFFFFFFFFFFFFFFFFFFFFFFFFFFFFFFFFFFFFFFFFFFFFFFFFFFFFFFFFFFFF 
 FFFFFFFFFFFFFFFFFFFFFFFFFFFFFFFFFFFFFFFFFFFFFFFFFFFFFFFFFFFFFFFF 
 FFFFFFFFF  FFFFFFFFFFFFFFFFFFFFFFFFFFFFFFFFFFFFFFFFFFFFFFFFFFFFF 
 FFFFFFFFF  FFFFFFFFFFFFFFFFFF                                    
 FFFFFFFFF  FFFFFFFFFFFFFFFFFF                  FFFFFFFFFFFFF     
 FFFFFFFFF  FFFFFFFFFFFFFFFFFF                  FFFFFF2FFFFFF     
            FFFFFFFFFFFFFFFFFF                  FFFFFFFFFFFFF     
            FFFFFFFFFFFFFFFFFF                  FFFFFFFFFFFFF     
            FFFFFFFFFFFFFFFFFF                      FFFFF         
                  FFFFFF                            FFFFF         
                  FFFFFF                            FFFFF         
     FFFFFFFFFFFFFFFFFFFFFFFFFFFFFFFFFFFFFFFFFFFFFFFFFFFFFFFFFFFF 
     FFFFFFFFFFFFFFFFFFFFFFFFFFFFFFFFFFFFFFFFFFFFFFFFFFFFFFFFFFFF 
     FFFFFFFFFFFFFFFFFFFFFFFFFFFFFFFFFFFFFFFFFFFFFFFFFFFFFFFFFFFF 
     F2FFFFFFFFFFFFFFFFFFFFFFFFFFFFFFFFFFFFFFFFFFFFFFFFFFFFFFFF3F 
     FFFFFFFFFFFFFFFFFFFFFFFFFFFFFFFFFFFFFFFFFFFFFFFFFFFFFFFFFFFF 
     FFFFFFFFFFFFFFFFFFFFFFFFFFFFFFFFFFFFFFFFFFFFFFFFFFFFFFFFFFFF 
     FFFFFFFFFFFFFFFFFFFFFFFFFFFFFFFFFFFFFFFFFFFFFFFFFFFFFFFFFFFF 
     FFFFFFFFFFFFFFFFFFFFFFFFFFFFFFFFFFFFFFFFFFFFFFFFFFFFFFFFFFFF 
                                                                  